# ===========================
#  Razorback Pass — Map Setup
# ===========================

RESET

# ---------------------------
# Background Terrain Image
# ---------------------------
BACKGROUND scripts/razorback-pass/images/razorback_pass_map.png


# ---------------------------
# Grid & Board Dimensions
# ---------------------------
GRID hex SIZE 56
BOARD 24x14


# ---------------------------
# Height Map (0–4)
# 4 = high ridge
# 3 = steep slope
# 2 = lower ridge / forest rise
# 1 = transition ground
# 0 = road
# ---------------------------

HEIGHT_START
4 4 4 4 4 4 4 4 4 4 4 4 4 3 3 4 4 4 4 4 4 4 4 4
4 4 4 4 4 4 4 4 4 4 4 4 4 3 3 3 4 4 4 4 4 4 4 4
4 4 4 4 4 4 4 4 4 3 3 4 4 4 4 4 4 4 4 4 4 4 4 4
4 4 4 4 4 4 4 3 3 4 4 4 4 4 4 4 4 4 4 4 4 4 4 4
4 4 4 4 4 3 3 3 2 2 2 2 2 3 3 3 4 4 4 4 4 4 4 4
0 0 0 0 0 0 0 0 0 0 0 0 0 0 0 0 0 0 0 0 0 0 0 0
0 0 0 0 0 0 0 0 0 1 1 1 1 1 1 0 0 0 0 0 0 0 0 0
0 0 0 0 0 0 0 1 1 1 2 2 2 1 1 1 0 0 0 0 0 0 0 0
2 2 2 2 1 1 1 1 1 2 2 2 1 1 1 2 2 2 1 1 1 2 2 2
2 2 2 2 1 1 1 1 1 2 3 3 2 1 1 1 1 1 2 2 2 3 3 3
3 3 3 3 1 1 1 1 1 2 3 3 2 1 1 1 1 1 2 3 3 3 4 4
4 4 4 4 2 2 2 2 2 3 4 4 3 2 2 2 2 2 3 4 4 4 4 4
HEIGHT_END